[
 [5, 0, 0, 0, 0, 0, 0, 0, 0, 0, 0, 0],
 [2, 0, 0, 0, 0, 0, 0, 0, 0, 0, 10, 0],
 [2, 0, 0, 0, 0, 0, 0, 0, 0, 0, 9, 0],
 [2, 0, 0, 0, 0, 0, 0, 0, 0, 0, 8, 0],
 [2, 0, 0, 0, 0, 0, 0, 0, 0, 0, 0, 0],
 [2, 0, 0, 0, 0, 0, 0, 0, 11, 0, 0, 0],
 [2, 0, 0, 0, 0, 0, 0, 0, 8, 0, 0, 0],
 [2, 0, 0, 0, 0, 8, 0, 0, 0, 0, 0, 0],
 [2, 0, 0, 0, 0, 0, 0, 0, 0, 0, 0, 0],
 [2, 5, 5, 5, 3, 3, 3, 3, 3, 6, 5, 5],
 [2, 2, 2, 2, 4, 4, 4, 4, 4, 7, 2, 2]
 ]
